###########
##...s...##
#.........#
#....b....#
#.........#
#.........#
#.........#
#.........#
#.........#
##...p...##
###########